Ы _ _ _ О
Б _ _ _ Z
В _ _ _ G
Т _ _ _ J
Р _ _ _ D

D _ Р Е Ш
Е D _ Z _
Z Е Б _ Л
О _ Ы _ R
G _ В Ж Э
Ж G _ J _
J Ж Т _ Щ

Ш _ D _ С
Л _ Z _ W
Э _ G _ S
Щ _ J _ У

W _ Л И К
И W _ R _
R И О М Ф
М R _ S _
S М Э _ Я
У _ Щ _ I

С _ Ш _ F
К _ W _ Q
Ф _ R _ V
Я _ S _ U

F _ С Д _
Q Д К Х А
V Х Ф Ц _
U Ц Я З Г
I З У _ _

Д F _ Q _
Х Q _ V _
Ц V _ U _
З U _ I _

А _ Q _ _
Г _ U _ _
